.....####
..#######
..#######
..#######
..#######
.#######.
..#######
.#######.
.#######.
.#######.
.#######.
#######..
.#######.
#######..
.####....